10 10
##########
#        #
##### ####
#        #
#   #### #
# #    # #
# ###    #
#    # # #
#        #
##########
